/Users/patricia/Documents/Tharsus/Labyrinth_simulation/New_labyrinth/venv/bin/python /Users/patricia/Documents/Tharsus/Labyrinth_simulation/New_labyrinth/main.py
tester
[[ 0  0  0  0  0  0  0  0  0  0  0  0  0  0  0]
 [ 2  1  1  1  1  1  1  1  1  1  1  0  0  1 -2]
 [ 0  0  0  0  0  0  0  1  0  0  0  0  0  1  0]
 [ 0  0  0  0  0  0  0  1  0  0  0  0  0  1  0]
 [ 0  2  0  0  1  0  0  1  1  1  1  0  0  1  0]
 [ 0  1  0  0  1  0  0  0  0  0  1  0  0  1  0]
 [ 0  1  0  0  1  0  0  0  0  0  1  0  0  1  0]
 [ 0  1  1  1  1  0  0  1  1  1  1  1  1  1  0]
 [ 0  0  0  0  1  0  0  0  0  0  0  0  0  1  0]
 [ 0  0  0  0  1  0  0  0  0  0  0  0  0  1  0]
 [ 0  1  0  0  1  0  0  1  1  1  1  1  1  1  0]
 [ 0  1  0  0  1  0  0  1  0  0  0  0  0  1  0]
 [ 0  1  0  0  1  0  0  1  0  0  0  0  0  1  0]
 [ 0  1  1  1  1  1  1  1  1  1  1  0  0  1  0]
 [ 0  0  0  0  3  0  0  3  0  0  0  0  0  0  0]]
----
[[ 0  0  0  0  0  0  0  0  0  0  0  0  0  0  0]
 [-1 -1 -1 -1 -1 -1 -1 -1 -1 -1 -1  0  0  1 -2]
 [ 0  0  0  0  0  0  0 -1  0  0  0  0  0  1  0]
 [ 0  0  0  0  0  0  0 -1  0  0  0  0  0  1  0]
 [ 0  2  0  0  1  0  0 -1 -1 -1 -1  0  0  1  0]
 [ 0  1  0  0  1  0  0  0  0  0 -1  0  0  1  0]
 [ 0  1  0  0  1  0  0  0  0  0 -1  0  0  1  0]
 [ 0  1  1  1  1  0  0  1  1  1 -1 -1 -1 -1  0]
 [ 0  0  0  0  1  0  0  0  0  0  0  0  0 -1  0]
 [ 0  0  0  0  1  0  0  0  0  0  0  0  0 -1  0]
 [ 0  1  0  0  1  0  0 -1 -1 -1 -1 -1 -1 -1  0]
 [ 0  1  0  0  1  0  0 -1  0  0  0  0  0 -1  0]
 [ 0  1  0  0  1  0  0 -1  0  0  0  0  0 -1  0]
 [ 0  1  1  1  1  1  1 -1 -1 -1 -1  0  0 -1  0]
 [ 0  0  0  0  3  0  0  3  0  0  0  0  0  0  0]]
----
[[ 0  0  0  0  0  0  0  0  0  0  0  0  0  0  0]
 [-2  1  1  1  1  1  1  1  1  1  1  0  0  1  2]
 [ 0  0  0  0  0  0  0  1  0  0  0  0  0  1  0]
 [ 0  0  0  0  0  0  0  1  0  0  0  0  0  1  0]
 [ 0  1  0  0  1  0  0  1  1  1  1  0  0  1  0]
 [ 0  1  0  0  1  0  0  0  0  0  1  0  0  1  0]
 [ 0  1  0  0  1  0  0  0  0  0  1  0  0  1  0]
 [ 0  2  1  1  1  0  0  1  1  1  1  1  1  1  0]
 [ 0  0  0  0  1  0  0  0  0  0  0  0  0  1  0]
 [ 0  0  0  0  1  0  0  0  0  0  0  0  0  1  0]
 [ 0  1  0  0  1  0  0  1  1  1  1  1  1  1  0]
 [ 0  1  0  0  1  0  0  1  0  0  0  0  0  1  0]
 [ 0  1  0  0  1  0  0  1  0  0  0  0  0  1  0]
 [ 0  1  1  1  1  1  1  1  1  1  1  0  0  1  0]
 [ 0  0  0  0  3  0  0  3  0  0  0  0  0  0  0]]
----
[[ 0  0  0  0  0  0  0  0  0  0  0  0  0  0  0]
 [-2  1  1  1  1  1  1  1  1  1  1  0  0 -1 -1]
 [ 0  0  0  0  0  0  0  1  0  0  0  0  0 -1  0]
 [ 0  0  0  0  0  0  0  1  0  0  0  0  0 -1  0]
 [ 0  1  0  0  1  0  0  1  1  1  1  0  0 -1  0]
 [ 0  1  0  0  1  0  0  0  0  0  1  0  0 -1  0]
 [ 0  1  0  0  1  0  0  0  0  0  1  0  0 -1  0]
 [ 0  2  1  1  1  0  0  1  1  1  1  1  1 -1  0]
 [ 0  0  0  0  1  0  0  0  0  0  0  0  0 -1  0]
 [ 0  0  0  0  1  0  0  0  0  0  0  0  0 -1  0]
 [ 0  1  0  0  1  0  0 -1 -1 -1 -1 -1 -1 -1  0]
 [ 0  1  0  0  1  0  0 -1  0  0  0  0  0 -1  0]
 [ 0  1  0  0  1  0  0 -1  0  0  0  0  0 -1  0]
 [ 0  1  1  1  1  1  1 -1 -1 -1 -1  0  0 -1  0]
 [ 0  0  0  0  3  0  0  3  0  0  0  0  0  0  0]]
----
{'solution_exists': True, 'solution': [[(1, 1), (2, 1), (3, 1), (4, 1), (5, 1), (7, 2), (7, 3), (7, 4), (8, 4), (9, 4), (10, 4), (10, 5), (10, 6), (10, 7), (11, 7), (12, 7), (13, 7), (13, 8), (12, 10), (11, 10), (10, 10), (9, 10), (8, 10), (7, 10), (7, 11), (7, 14), (7, 14)], [(13, 1), (13, 2), (13, 3), (13, 4), (13, 5), (13, 6), (13, 7), (13, 8), (12, 10), (11, 10), (10, 10), (9, 10), (8, 10), (7, 10), (7, 11), (7, 14), (7, 14)]]}
[[ 0  0  0  0  0  0  0  0  0  0  0  0  0  0  0]
 [ 0  0  0  0  0  0  0  0  0  0  0  0  0  0  0]
 [ 0  0  0  0  0  0  0  0  0  0  0  0  0  0  0]
 [ 0  0  0  0  0  0  0  0  0  0  0  0  0  0  0]
 [ 0  1  1  1  1  1  1  1  1  1  1  1  1  1  3]
 [ 0  1  0  0  0  0  0  0  0  0  0  1  0  0  0]
 [ 0  1  1  1  1  1  0  0  0  0  0  1  0  0  0]
 [ 0  0  0  0  0  1  0  0  0  0  0  1  0  0  0]
 [ 2  1  1  1  1  1  1  1  1  1  1  1  0  0  0]
 [ 0  0  0  0  1  0  1  0  0  0  0  1  0  0  0]
 [ 0  0  0  0  1  0  1  1  1  1  0  1  0  0  0]
 [ 0  0  0  0  1  0  0  0  0  1  0  1  0  0  0]
 [ 0  0  0  0  1  0  1  1  1  1  0  1  0  0  0]
 [ 0  0  0  0  1  1  1  0  0  0  0  1  0  0  0]
 [ 0  0  0  0 -2  0  0  0  2  0  0  3  0  0  0]]
----
[[ 0  0  0  0  0  0  0  0  0  0  0  0  0  0  0]
 [ 0  0  0  0  0  0  0  0  0  0  0  0  0  0  0]
 [ 0  0  0  0  0  0  0  0  0  0  0  0  0  0  0]
 [ 0  0  0  0  0  0  0  0  0  0  0  0  0  0  0]
 [ 0  1  1  1  1  1  1  1  1  1  1  1  1  1  3]
 [ 0  1  0  0  0  0  0  0  0  0  0  1  0  0  0]
 [ 0  1  1  1  1  1  0  0  0  0  0  1  0  0  0]
 [ 0  0  0  0  0  1  0  0  0  0  0  1  0  0  0]
 [-1 -1 -1 -1 -1 -1 -1 -1 -1 -1 -1 -1  0  0  0]
 [ 0  0  0  0  1  0  1  0  0  0  0 -1  0  0  0]
 [ 0  0  0  0  1  0  1  1  1  1  0 -1  0  0  0]
 [ 0  0  0  0  1  0  0  0  0  1  0 -1  0  0  0]
 [ 0  0  0  0  1  0  1  1  1  1  0 -1  0  0  0]
 [ 0  0  0  0  1  1  1  0  0  0  0 -1  0  0  0]
 [ 0  0  0  0 -2  0  0  0  2  0  0  3  0  0  0]]
----
[[ 0  0  0  0  0  0  0  0  0  0  0  0  0  0  0]
 [ 0  0  0  0  0  0  0  0  0  0  0  0  0  0  0]
 [ 0  0  0  0  0  0  0  0  0  0  0  0  0  0  0]
 [ 0  0  0  0  0  0  0  0  0  0  0  0  0  0  0]
 [ 0  1  1  1  1  1  1  1  1  1  1  1  1  1  3]
 [ 0  1  0  0  0  0  0  0  0  0  0  1  0  0  0]
 [ 0  1  1  1  1  1  0  0  0  0  0  1  0  0  0]
 [ 0  0  0  0  0  1  0  0  0  0  0  1  0  0  0]
 [-2  1  1  1  1  1  1  1  1  1  1  1  0  0  0]
 [ 0  0  0  0  1  0  1  0  0  0  0  1  0  0  0]
 [ 0  0  0  0  1  0  1  1  1  1  0  1  0  0  0]
 [ 0  0  0  0  1  0  0  0  0  1  0  1  0  0  2]
 [ 0  0  0  0  1  0  1  1  1  1  0  1  0  0  0]
 [ 0  0  0  0  1  1  1  0  0  0  0  1  0  0  0]
 [ 0  0  0  0  2  0  0  0  0  0  0  3  0  0  0]]
----
[[ 0  0  0  0  0  0  0  0  0  0  0  0  0  0  0]
 [ 0  0  0  0  0  0  0  0  0  0  0  0  0  0  0]
 [ 0  0  0  0  0  0  0  0  0  0  0  0  0  0  0]
 [ 0  0  0  0  0  0  0  0  0  0  0  0  0  0  0]
 [ 0  1  1  1  1  1  1  1  1  1  1  1  1  1  3]
 [ 0  1  0  0  0  0  0  0  0  0  0  1  0  0  0]
 [ 0  1  1  1  1  1  0  0  0  0  0  1  0  0  0]
 [ 0  0  0  0  0  1  0  0  0  0  0  1  0  0  0]
 [-2  1  1  1  1  1 -1 -1 -1 -1 -1 -1  0  0  0]
 [ 0  0  0  0  1  0 -1  0  0  0  0 -1  0  0  0]
 [ 0  0  0  0  1  0 -1 -1 -1 -1  0 -1  0  0  0]
 [ 0  0  0  0  1  0  0  0  0 -1  0 -1  0  0  2]
 [ 0  0  0  0  1  0 -1 -1 -1 -1  0 -1  0  0  0]
 [ 0  0  0  0 -1 -1 -1  0  0  0  0 -1  0  0  0]
 [ 0  0  0  0 -1  0  0  0  0  0  0  3  0  0  0]]